5, 8, 11, 26, 14, 9, 13, 5, 20, 10
12, 20, 17, 16, 23, 10, 8, 40, 12, 23
18, 20, 42, 50, 42, 51, 10, 24, 8, 12
9, 29, 41, 41, 46, 29, 65, 58, 17, 17
12, 24, 42, 42, 27, 21, 42, 67, 27, 36
33, 24, 46, 50, 41, 26, 68, 51, 6, 30
18, 39, 24, 64, 16, 83, 5, 31, 36, 25
9, 23, 9, 31, 68, 8, 34, 22, 20, 39
19, 12, 16, 8, 36, 37, 28, 35, 12, 27
12, 18, 20, 40, 39, 38, 30, 21, 6, 9
